40 40 28 28
FFFFFFFFFFFFRRRRFFFFFFFFFFFFFFFFFFFFFFFF
FFFFFFFFFFFFFRRRRFFFFFFFFFFFFFFFFFFFFFFF
----------FFFFRRRFFFFFFFFFFFFFFFFFFFFFFF
FFFFFFFFF-FFFFRRRRFFFFFFFFFFFFFFFFFFFFFF
FFFFFFFFF-FFFFRRRRRFFFFFFFFFFFFFFFFFFFFF
FFFFFFFFF-FFFFFRRRRRFFF----------------f
FFFFFF----FFFFFRRRRRFFF-FFFFFFFFFFFFFFFF
FFFFFF-FFFFFFFRRRRRRFFF-FFFFFFFFFFFFFFFF
FFFFFF-FFFFFRRRRRRFFFFFDFFFFFFFFFFFFFFFF
FFFFFF------------------FFFFFFFFFFFFFFFF
FFFFFFDFFRRRRRRFFFFFFFF----RRFFFFFFFFFFF
FFFFFF-RRRRRFFFFFFFFFFFFRR-RRRRFFFFFFFFF
FFFFFR-RRRFFFFFFFFFFFFRRRR-RRRRFFFFFFFFF
FFFFFR-RRRFFFFFFFFFFFRRRRR-RRRFFFFFFFRRR
FFFFFF-RRRRFFFFFFFFFFFRRRR-RFFFFFFFRRRRR
FFFFFF-FRRRRRFFFFFFFFFFFRR-FFFFFFRRRRFFF
FFFFFF-FFRRRRRRFFFFFFFFFFF-FFFFRRRRRFFFF
FFFFFF-FFFRRRRRRFFFFFFFFFF-FFRRRRRRFFFFF
FFFFFF---------------------D-----------f
FFFFFFFFFFFFFRRRDRRFFFFFFFFRRRRRFFFFFFFF
FFFFFFFFFFFFFFFF-RRRRFFFFFRRRRRFFFFFFFFF
FFFFFFFFFFFFFFFF-FFRRRRRFFRRRRFFFFFFFFFF
FFFFFFFFFFFFFFFF-FFFFRRRRRRRRFFFFFFFFFFF
FFFFFFFFFFFFFFFF-FFFFFRRRRRRFFFFFFFFFFFF
-----------------FFFFFRRRRRFFFFFFFFFFFFF
FFFFFFFFFFFFFFFF-FFFFFRRRRRFFFFFFFFFFFFF
FFFFFFFFFFFFFFFF-FFFFRRRRRFFFFFFFFFFFFFF
FFFFFFFFFFFFFFFF-FFRRRRRRFFFFFFFFFFFFFFF
FFFFFFFFFFFFFFFF-RRRRRRFFFFFFFFFFFFFFFFF
FFFFFFFFFFFFRRRR-------D----FFFFFFFFFFFF
FFFFFFFFFRRRRRRR-RRFFFFFFFF-FFFFFFFFFFFF
FFFFFFFRRRRRRRRR-FFFFFFFFFF-FFFFFFFFFFFF
FFFFFRRRRRRRFFFF-FFFFFFFFFF-FFFFFFFFFFFF
FFRRRRRRFFFFFFFF-FFFFFFFFFF-FFFFFFFFFFFF
RRRRRRRFFFFFFFFF-FFFFFFFFFF-FFFFFFFFFFFF
RRRRRRRFFFFFFFFF-FFFFFFFFFF-------------
FFFFFFFFFFFFFFFF-FFFFFFFFFFFFFFFFFFFFFFF
FFFFFFFFFFFFFFFF-FFFFFFFFFFFFFFFFFFFFFFF
FFFFFFFFFFFFFFFF-FFFFFFFFFFFFFFFFFFFFFFF
FFFFFFFFFFFFFFFF-FFFFFFFFFFFFFFFFFFFFFFF
